NO ./asset/bluestone.xpm
SO ./asset/purplestone.xpm
WE ./asset/eagle.xpm
EA ./asset/redbrick.xpm

F 220,100,0
C 225,30,0

1111111
1000001
1000001
1000001
1001001
1000001
1000101
1001N11
1000101
1111111

