     NO             ./asset/loup.xpm
EA 						./asset/loup.xpm
WE										 ./asset/loup.xpm
SO 									  	./asset/loup.xpm

  F 220,100,0
	C      225,30,0

         1111111111111111111111111
         1000000000110000000000001
1        011000001110000000000011
         1001000000000000000000001
111111111011000001110000000000001
100000000011000001110111111111111

11110111111111011100000011111
11110111111111011101010010001
11000000110101011100000010001
10000000 00000001100000010001
10000000000000011010100100011
1100000111010101111101111000111
11110111 1110101 10111101 N 1
11111111 1111111 111111111111